++++++++
+......+
+......+
+..ad..+
+......+
+......+
+......+
++++++++