++++++++
+......+
+......+
+......+
+......+
+......+
+d....*+
++++++++