++++++++
+......+
+..++..+
+..+*..+
+..a+..+
+..++..+
+......+
++++++++