++++++++
+*.....+
+++..+++
+......+
+......+
+++..+++
+.....d+
++++++++