++++++++
+......+
+.++++.+
+.+^.+.+
+.++.+.+
+......+
+......+
++++++++