++++++++
+......+
+.++.+.+
+.+.1+.+
+.+^.+.+
+.++++.+
+......+
++++++++