++++++++
+......+
+.++++.+
+.+^.+.+
+.+.1+.+
+.++.+.+
+......+
++++++++