++++++++
+^.....+
+......+
+......+
+......+
+......+
+......+
++++++++