++++++++
+++..+++
+++..+++
+......+
+......+
+.+..+++
+^+..+++
++++++++