++++++++
+.+..+++
+.+..+++
+......+
+......+
+++..+.+
+++..+^+
++++++++