++++++++
+..1a..+
+....1.+
+.p++..+
+..++..+
+......+
+......+
++++++++