++++++++
+......+
+......+
+.p++..+
+..++..+
+......+
+......+
++++++++