++++++++
++....++
+......+
+...p..+
+......+
+......+
++....++
++++++++