++++++++
+......+
+..+...+
+..p.+.+
+.+....+
+...+..+
+......+
++++++++