+++..+++
+.+..+.+
+......+
..+..+..
........
+.+..+.+
+......+
+++..+++