++++++++
+.+..+.+
+......+
+.+..+.+
+......+
+.+..+.+
+......+
++++++++