+++..+++
+......+
+......+
........
........
+......+
+......+
+++..+++