++++++++
+......+
+......+
+.p....+
+......+
+......+
+......+
++++++++