+++..+++
+......+
+......+
..p.....
........
+......+
+......+
+++..+++