++++++++
+.p....+
+......+
+......+
+......+
+......+
+......+
++++++++