++++++++
+......+
+.++++.+
+.+a.+.+
+.++=+.+
+......+
+......+
++++++++