++++++++
+a+..+d+
+=+..+=+
+......+
+......+
+..++..+
+......+
++++++++