++++++++
+*+..+d+
+=+..+=+
+......+
+......+
+..++..+
+......+
++++++++