++++++++
+++..+++
+++..+++
+......+
+......+
+=+..+=+
+*+..+*+
++++++++