++++++++
+++..+++
+++..+++
+......+
+......+
+=+..+=+
+a+..+*+
++++++++