++++++++
+......+
+..++..+
+.+1a+.+
+.==*+.+
+..++..+
+......+
++++++++