++++++++
+......+
+......+
+..1...+
+...1..+
+......+
+......+
++++++++