++++++++
+......+
+....1.+
+..++..+
+..++..+
+.1....+
+......+
++++++++