++++++++
+......+
+......+
+..++..+
+..1+..+
+......+
+......+
++++++++