++++++++
+......+
+......+
+..+1..+
+..+...+
+......+
+......+
++++++++