++++++++
+......+
+......+
+...+..+
+..1+..+
+......+
+......+
++++++++