++++++++
+.....1+
+..+++++
+......+
+......+
+++++..+
+1.....+
++++++++