++++++++
+1+....+
+.+....+
+......+
+......+
+....+.+
+....+1+
++++++++