++++++++
+......+
+.++.+.+
+.+..+.+
+.+..+.+
+.++++.+
+......+
++++++++