++++++++
+......+
+.++.+.+
+.+..+.+
+.+s.+.+
+.++++.+
+......+
++++++++