++++++++
+s....s+
+......+
+......+
+......+
+......+
+s....s+
++++++++