++++++++
+......+
+......+
+..ss..+
+..ss..+
+......+
+......+
++++++++