++++++++
+......+
+......+
+.+s.+.+
+.+.1+.+
+......+
+......+
++++++++