++++++++
+......+
+..++..+
+..1...+
+...s..+
+..++..+
+......+
++++++++