++++++++
+++..+++
+++..+++
+......+
+......+
+++..+++
+++..+++
++++++++