++++++++
+......+
+..++..+
+.++++.+
+.++++.+
+..++..+
+......+
++++++++