++++++++
+......+
+.++++++
+.+....+
+....+.+
++++++.+
+......+
++++++++