++++++++
+......+
+.+..+.+
+......+
+......+
+.+..+.+
+......+
++++++++