++++++++
+++..+++
+++.++++
+.+....+
+....+.+
++++.+++
+++..+++
++++++++