++++++++
+......+
+.++++.+
+......+
+......+
+.++++.+
+......+
++++++++