++++++++
+......+
+.+..+.+
+.+..+.+
+.+..+.+
+.+..+.+
+......+
++++++++