++++++++
++....++
+.+..+.+
+......+
+......+
+.+..+.+
++....++
++++++++