++++++++
+......+
+..++..+
+..++..+
+..++..+
+..++..+
+......+
++++++++